id,date_processed,cycle,files_received,total_records_processed,Receipt_control_time,Databricks_job_run ,DBX,TOTAL_RC_DBX,BOL
152,7/27/2024,1,0,0,0,,0,0,0
74,9/16/2024,1,1,49,6,9/16/2024 8:51,9,15,6
108,8/24/2024,1,1,293744,4,8/24/2024 3:29,14,18,7
31,10/12/2024,1,1,9894,4,10/12/2024 3:29,10,14,7
157,7/24/2024,3,1,173000,8,7/24/2024 13:33,14,22,11
339,3/30/2024,1,1,123,6,3/30/2024 11:08,8,14,12
9,10/26/2024,1,1,60079,8,10/26/2024 3:33,10,18,13
328,4/6/2024,1,1,7305,5,4/6/2024 3:23,8,13,13
251,5/25/2024,1,1,264619,8,5/25/2024 3:28,13,21,17
37,10/9/2024,1,1,39997,6,10/9/2024 3:31,11,17,18
299,4/25/2024,1,1,28710,5,4/25/2024 3:23,10,15,18
218,6/15/2024,1,1,9223,8,6/15/2024 3:32,9,17,18
213,6/19/2024,1,1,444499,6,6/19/2024 3:30,15,21,19
229,6/8/2024,1,1,132429,5,6/8/2024 3:24,10,15,19
240,6/1/2024,1,1,132220,6,6/1/2024 6:50,10,16,19
103,8/28/2024,1,1,99604,5,8/28/2024 3:30,12,17,19
312,4/17/2024,1,1,89690,5,4/17/2024 3:23,10,15,19
244,5/30/2024,1,1,75138,8,5/30/2024 3:28,10,18,19
35,10/10/2024,1,1,53281,4,10/10/2024 3:29,12,16,19
350,3/23/2024,1,1,34726,7,3/23/2024 3:25,8,15,19
101,8/29/2024,1,1,22111,5,8/29/2024 3:30,14,19,19
75,9/14/2024,1,1,15521,7,9/14/2024 3:32,11,18,19
321,4/11/2024,1,1,13878,5,4/11/2024 3:23,10,15,19
355,3/20/2024,3,4,8026393,20,3/20/2024 14:24,125,145,20
121,8/16/2024,1,1,384271,12,8/16/2024 3:36,17,29,20
255,5/23/2024,1,1,358308,5,5/23/2024 3:25,15,20,20
376,3/7/2024,1,1,356021,12,3/7/2024 4:35,14,26,20
246,5/29/2024,1,1,349262,5,5/29/2024 3:25,14,19,20
189,7/4/2024,1,1,327437,4,7/4/2024 3:29,15,19,20
24,10/17/2024,1,1,268102,11,10/17/2024 3:36,12,23,20
348,3/25/2024,3,1,232310,8,3/25/2024 13:35,11,19,20
249,5/27/2024,3,1,226779,7,5/27/2024 14:11,12,19,20
156,7/25/2024,1,1,202168,6,7/25/2024 3:31,15,21,20
26,10/16/2024,1,1,184437,7,10/16/2024 3:32,13,20,20
180,7/10/2024,1,1,116128,4,7/10/2024 3:29,11,15,20
319,4/12/2024,1,1,91883,6,4/12/2024 3:24,11,17,20
158,7/24/2024,1,1,82154,5,7/24/2024 3:30,11,16,20
233,6/6/2024,1,1,63055,8,6/6/2024 3:27,10,18,20
15,10/23/2024,1,1,56396,7,10/23/2024 3:33,9,16,20
53,9/28/2024,1,1,55780,5,9/28/2024 3:29,10,15,20
367,3/13/2024,1,1,46242,8,3/13/2024 3:26,11,19,20
13,10/24/2024,1,1,44037,5,10/24/2024 3:25,11,16,20
70,9/18/2024,1,1,39921,4,9/18/2024 5:37,11,15,20
228,6/10/2024,1,1,37526,5,6/10/2024 3:24,9,14,20
343,3/28/2024,1,1,34164,6,3/28/2024 3:24,10,16,20
123,8/15/2024,1,1,31808,4,8/15/2024 3:29,13,17,20
323,4/10/2024,1,1,21213,5,4/10/2024 3:23,9,14,20
365,3/14/2024,1,1,19045,5,3/14/2024 3:23,11,15,20
174,7/13/2024,1,1,4627,5,7/13/2024 3:29,10,15,20
132,8/9/2024,1,1,685702,7,8/9/2024 3:32,21,28,21
284,5/4/2024,1,1,619381,5,5/4/2024 3:24,18,23,21
253,5/24/2024,1,1,588373,10,5/24/2024 3:30,19,29,21
11,10/25/2024,1,1,513891,7,10/25/2024 5:57,19,26,21
166,7/18/2024,3,1,380650,9,7/18/2024 13:33,15,24,21
361,3/16/2024,1,1,355435,5,3/16/2024 3:18,14,19,21
352,3/22/2024,1,1,327864,9,3/22/2024 3:27,13,22,21
4,10/30/2024,1,1,313870,5,10/30/2024 3:30,16,21,21
119,8/17/2024,1,1,258272,4,8/17/2024 3:29,14,18,21
95,9/2/2024,3,1,249086,8,9/2/2024 13:32,14,22,21
97,8/31/2024,1,1,195844,4,8/31/2024 8:59,156,160,21
221,6/13/2024,3,1,162784,9,6/13/2024 13:33,12,21,21
257,5/22/2024,1,1,156441,5,5/22/2024 3:25,12,17,21
12,10/24/2024,3,1,112774,8,10/24/2024 13:33,11,19,21
81,9/11/2024,1,1,98101,7,9/11/2024 3:32,13,20,21
375,3/7/2024,3,1,93838,7,3/7/2024 13:24,11,18,21
372,3/9/2024,1,1,71064,8,3/9/2024 3:25,11,19,21
370,3/11/2024,1,1,68715,8,3/11/2024 1:26,9,17,21
333,4/3/2024,3,1,58643,9,4/3/2024 13:27,9,18,21
145,8/1/2024,1,1,50701,6,8/1/2024 9:14,14,20,21
14,10/23/2024,3,1,49992,7,10/23/2024 13:32,11,18,21
3,10/30/2024,3,1,48358,6,10/30/2024 13:31,10,16,21
100,8/29/2024,3,1,26122,9,8/29/2024 13:34,11,20,21
169,7/17/2024,1,1,882731,6,7/17/2024 3:30,24,30,22
262,5/18/2024,1,1,870487,5,5/18/2024 3:25,20,25,22
231,6/7/2024,1,1,717499,19,6/7/2024 3:38,19,38,22
90,9/5/2024,1,1,659501,5,9/5/2024 3:30,22,27,22
134,8/8/2024,1,1,641252,6,8/8/2024 3:30,21,27,22
130,8/10/2024,1,1,588989,5,8/10/2024 3:29,20,25,22
86,9/7/2024,1,1,548268,5,9/7/2024 3:30,17,22,22
154,7/26/2024,1,1,521581,5,7/26/2024 3:30,19,24,22
220,6/14/2024,1,1,519642,6,6/14/2024 3:30,18,24,22
209,6/21/2024,1,1,490033,15,6/21/2024 3:39,17,32,22
242,5/31/2024,1,1,430034,7,5/31/2024 3:27,17,24,22
363,3/15/2024,1,1,415937,9,3/15/2024 3:27,16,25,22
373,3/8/2024,3,1,409437,9,3/8/2024 13:26,15,24,22
238,6/3/2024,3,1,404144,10,6/3/2024 13:29,14,24,22
131,8/9/2024,3,1,398028,8,8/9/2024 13:33,17,25,22
362,3/15/2024,3,1,396561,9,3/15/2024 13:27,10,19,22
68,9/19/2024,1,1,383232,8,9/19/2024 3:33,17,25,22
168,7/17/2024,3,1,365582,9,7/17/2024 13:42,14,23,22
40,10/7/2024,3,1,317742,9,10/7/2024 13:34,15,24,22
84,9/9/2024,3,1,311059,8,9/9/2024 13:33,15,23,22
48,10/2/2024,1,1,259163,6,10/2/2024 3:31,15,21,22
378,3/6/2024,1,1,217440,5,3/6/2024 3:24,13,18,22
147,7/31/2024,1,1,208337,6,7/31/2024 3:31,16,22,22
150,7/29/2024,3,1,207802,7,7/29/2024 13:32,13,20,22
243,5/30/2024,3,1,206132,8,5/30/2024 13:28,13,21,22
36,10/9/2024,3,1,142502,7,10/9/2024 13:32,12,19,22
298,4/25/2024,3,1,137920,10,4/25/2024 13:28,12,22,22
232,6/6/2024,3,1,116442,9,6/6/2024 13:38,10,19,22
79,9/12/2024,1,1,115784,7,9/12/2024 3:31,13,20,22
133,8/8/2024,3,1,111304,8,8/8/2024 13:33,5,13,22
274,5/10/2024,3,1,110455,9,5/10/2024 13:28,10,19,22
179,7/10/2024,3,1,106487,9,7/10/2024 13:33,10,19,22
366,3/13/2024,3,1,99670,10,3/13/2024 13:28,10,20,22
254,5/23/2024,3,1,88351,8,5/23/2024 13:28,10,18,22
112,8/22/2024,1,1,83657,6,8/22/2024 3:32,14,20,22
208,6/21/2024,3,1,71708,9,6/21/2024 13:33,9,18,22
364,3/14/2024,3,1,64579,9,3/14/2024 13:26,10,19,22
124,8/14/2024,3,1,45461,9,8/14/2024 13:34,12,21,22
102,8/28/2024,3,1,44676,8,8/28/2024 13:33,11,19,22
155,7/25/2024,3,1,8434,7,7/25/2024 15:20,3,10,22
99,8/30/2024,1,1,1147816,8,8/30/2024 3:33,28,36,23
317,4/13/2024,1,1,1128352,6,4/13/2024 3:24,26,32,23
191,7/3/2024,1,1,1091135,6,7/3/2024 6:38,27,33,23
163,7/20/2024,1,1,953450,6,7/20/2024 3:32,24,30,23
143,8/2/2024,1,1,713188,7,8/2/2024 3:32,24,31,23
109,8/23/2024,3,1,669991,28,8/23/2024 13:53,20,48,23
187,7/5/2024,1,1,609077,6,7/5/2024 3:31,19,25,23
341,3/29/2024,1,1,528715,8,3/29/2024 3:26,18,26,23
359,3/18/2024,3,1,520980,9,3/18/2024 13:27,16,25,23
98,8/30/2024,3,1,499314,8,8/30/2024 13:33,17,25,23
76,9/13/2024,3,1,497399,8,9/13/2024 13:33,17,25,23
216,6/17/2024,3,1,445574,9,6/17/2024 13:33,15,24,23
275,5/10/2024,1,1,429781,6,5/10/2024 3:25,16,22,23
340,3/29/2024,3,1,418794,9,3/29/2024 13:27,14,23,23
183,7/8/2024,3,1,387813,7,7/8/2024 14:09,8,15,23
10,10/25/2024,3,1,370993,8,10/25/2024 13:33,15,23,23
326,4/8/2024,3,1,365258,9,4/8/2024 13:27,14,23,23
54,9/27/2024,3,1,348479,10,9/27/2024 13:34,13,23,23
190,7/3/2024,3,1,334758,9,7/3/2024 13:34,12,21,23
337,4/1/2024,3,1,205631,9,4/1/2024 16:29,11,20,23
135,8/7/2024,3,1,133899,8,8/7/2024 13:33,13,21,23
311,4/17/2024,3,1,128540,8,4/17/2024 13:26,11,19,23
23,10/17/2024,3,1,121330,8,10/17/2024 13:33,12,20,23
200,6/27/2024,1,1,119604,9,6/27/2024 3:34,12,21,23
322,4/10/2024,3,1,105639,9,4/10/2024 13:27,9,18,23
122,8/15/2024,3,1,87618,8,8/15/2024 13:33,12,20,23
320,4/11/2024,3,1,83641,9,4/11/2024 13:27,10,19,23
80,9/11/2024,3,1,57040,7,9/11/2024 13:32,11,18,23
136,8/7/2024,1,1,52300,9,8/7/2024 3:34,11,20,23
59,9/25/2024,1,1,32523,14,9/25/2024 6:39,11,25,23
141,8/3/2024,1,1,1707745,7,8/3/2024 3:31,36,43,24
356,3/20/2024,1,1,1488097,12,3/20/2024 4:58,27,39,24
185,7/6/2024,1,1,1389386,6,7/6/2024 3:36,30,36,24
263,5/17/2024,3,1,836950,9,5/17/2024 13:29,21,30,24
230,6/7/2024,3,1,752591,10,6/7/2024 13:29,21,31,24
252,5/24/2024,3,1,532748,9,5/24/2024 13:29,16,27,24
353,3/21/2024,3,1,422325,10,3/21/2024 13:27,14,24,24
87,9/6/2024,3,1,397911,32,9/6/2024 13:57,16,48,24
176,7/12/2024,1,1,391246,11,7/12/2024 3:35,15,26,24
241,5/31/2024,3,1,362633,9,5/31/2024 13:28,14,23,24
32,10/11/2024,3,1,354928,24,10/11/2024 13:49,16,40,24
144,8/1/2024,3,1,135675,9,8/1/2024 13:42,17,26,24
287,5/2/2024,3,1,112330,10,5/2/2024 13:28,10,20,24
22,10/18/2024,1,1,1581273,8,10/18/2024 3:33,34,42,25
125,8/14/2024,1,1,1556842,6,8/14/2024 7:14,36,42,25
46,10/3/2024,1,1,1435289,6,10/3/2024 3:32,32,38,25
165,7/19/2024,1,1,1428584,7,7/19/2024 3:32,33,40,25
334,4/3/2024,1,1,1126754,7,4/3/2024 3:25,26,23,25
315,4/15/2024,3,1,1117431,10,4/15/2024 13:28,25,35,25
245,5/29/2024,3,1,957068,9,5/29/2024 13:34,28,37,25
25,10/16/2024,3,1,914486,8,10/16/2024 15:33,27,35,25
256,5/22/2024,3,1,677672,7,5/22/2024 13:27,20,27,25
374,3/8/2024,1,1,436975,7,3/8/2024 3:24,16,23,25
45,10/3/2024,3,1,399506,9,10/3/2024 13:34,17,26,25
1,10/31/2024,3,1,164576,27,10/31/2024 13:52,14,41,25
177,7/11/2024,3,1,126081,31,7/11/2024 13:55,16,47,25
301,4/24/2024,1,1,97321,10,4/24/2024 3:28,10,20,25
290,5/1/2024,1,1,83494,3,5/1/2024 8:25,10,13,25
42,10/5/2024,3,1,2099118,9,10/5/2024 3:44,40,49,26
92,9/4/2024,1,1,2045614,7,9/4/2024 3:42,42,49,26
286,5/3/2024,1,1,1635197,8,5/3/2024 3:25,33,41,26
167,7/18/2024,1,1,1194572,6,7/18/2024 3:30,30,36,26
44,10/4/2024,1,1,874069,17,10/4/2024 3:42,24,41,26
20,10/19/2024,1,1,803747,15,10/19/2024 3:40,23,38,26
67,9/19/2024,3,1,557425,7,9/19/2024 13:32,18,25,26
78,9/12/2024,3,1,372487,9,9/12/2024 13:34,16,25,26
34,10/10/2024,3,1,164904,9,10/10/2024 13:34,12,21,26
377,3/6/2024,3,1,153778,41,3/6/2024 15:03,11,42,26
69,9/18/2024,3,1,141145,9,9/18/2024 13:34,13,22,26
58,9/25/2024,3,1,137767,10,9/25/2024 13:35,11,21,26
309,4/18/2024,3,1,65973,31,4/18/2024 13:59,10,41,26
265,5/16/2024,3,1,623880,8,5/16/2024 13:29,21,29,27
113,8/21/2024,3,1,473574,31,8/21/2024 13:56,16,47,27
219,6/14/2024,3,1,361974,9,6/14/2024 13:33,13,22,27
210,6/20/2024,3,6,13839135,32,6/20/2024 16:08,207,239,28
89,9/5/2024,3,1,2525491,11,9/5/2024 13:47,57,68,28
267,5/15/2024,3,1,1865540,10,5/15/2024 13:37,38,48,28
153,7/26/2024,3,1,1491001,10,7/26/2024 13:40,32,42,28
196,6/29/2024,1,1,1457762,10,6/29/2024 3:45,31,41,28
164,7/19/2024,3,1,1368537,9,7/19/2024 13:38,30,39,28
56,9/26/2024,3,1,480905,34,9/26/2024 13:59,18,52,28
77,9/13/2024,1,1,1800264,8,9/13/2024 3:43,39,47,29
306,4/20/2024,1,1,1179347,6,4/20/2024 3:29,26,32,29
330,4/5/2024,1,1,970312,6,4/5/2024 3:24,22,28,29
198,6/28/2024,1,1,892610,8,6/28/2024 3:33,23,31,29
47,10/2/2024,3,1,687030,9,10/2/2024 13:34,22,31,29
351,3/22/2024,3,1,681602,9,3/22/2024 13:27,18,27,29
332,4/4/2024,1,1,539974,7,4/4/2024 3:24,18,25,29
197,6/28/2024,3,1,409251,9,6/28/2024 13:35,14,23,29
385,3/1/2024,1,1,381532,4,3/1/2024 8:40,17,21,29
344,3/27/2024,3,1,74676,3,3/27/2024 14:07,11,14,29
202,6/26/2024,1,1,400080,9,6/26/2024 9:17,15,24,30
293,4/29/2024,3,1,324308,35,4/29/2024 13:53,13,48,30
276,5/9/2024,3,1,2765564,12,5/9/2024 13:45,48,60,31
186,7/5/2024,3,1,1539389,10,7/5/2024 13:41,37,47,31
207,6/22/2024,1,1,933096,10,6/22/2024 3:34,21,31,31
199,6/27/2024,3,1,786070,11,6/27/2024 13:36,24,35,31
111,8/22/2024,3,1,171302,11,8/22/2024 13:36,14,25,31
161,7/22/2024,3,1,2753495,11,7/22/2024 16:33,67,78,32
73,9/16/2024,3,1,1614430,10,9/16/2024 13:40,37,47,32
120,8/16/2024,3,1,957514,11,8/16/2024 14:45,20,31,32
217,6/17/2024,1,1,631013,5,6/17/2024 3:30,22,27,32
224,6/12/2024,1,1,1599164,7,6/12/2024 3:36,32,39,33
307,4/19/2024,3,1,1240772,34,4/19/2024 14:59,27,61,33
223,6/12/2024,1,1,544396,10,6/12/2024 13:34,18,28,33
383,3/2/2024,1,1,839456,6,3/2/2024 3:25,30,36,34
345,3/27/2024,1,1,457285,8,3/27/2024 3:26,19,27,34
2,10/31/2024,1,1,81452,20,10/31/2024 3:45,13,33,34
142,8/2/2024,3,2,3333141,15,8/2/2024 14:22,61,76,35
342,3/28/2024,3,1,149513,9,3/28/2024 13:27,11,20,35
295,4/27/2024,1,2,3576231,8,4/27/2024 3:46,60,68,36
65,9/20/2024,3,1,2974752,37,9/20/2024 14:12,63,100,36
211,6/20/2024,1,1,1897517,17,6/20/2024 3:51,38,55,36
201,6/26/2024,3,1,2505977,12,6/26/2024 14:35,46,58,37
234,6/5/2024,3,1,2473289,42,6/5/2024 14:23,57,99,37
173,7/15/2024,1,2,4266048,11,7/15/2024 10:23,75,86,38
175,7/12/2024,1,1,2482912,10,7/12/2024 13:44,47,57,38
296,4/26/2024,3,1,1352687,10,4/26/2024 13:33,29,39,39
8,10/28/2024,1,2,4663027,10,10/28/2024 3:54,83,93,40
282,5/6/2024,3,2,4556570,12,5/6/2024 14:41,78,90,40
206,6/24/2024,1,4,8137752,15,6/24/2024 4:29,125,140,41
336,4/2/2024,1,3,5108910,14,4/2/2024 8:53,90,104,41
289,5/1/2024,3,2,3614717,12,5/1/2024 14:16,63,75,41
178,7/11/2024,1,1,22376,9,7/11/2024 3:35,11,20,41
272,5/13/2024,1,2,3178292,7,5/13/2024 11:17,57,64,42
288,5/2/2024,1,2,3905461,9,5/2/2024 3:44,66,75,43
329,4/5/2024,3,2,3805720,12,4/5/2024 13:47,70,82,43
318,4/12/2024,3,1,2483103,12,4/12/2024 13:39,46,58,43
194,7/1/2024,3,3,5012509,14,7/1/2024 14:08,82,96,44
300,4/24/2024,3,1,89569,39,4/24/2024 13:56,11,50,44
349,3/25/2024,1,4,9029191,21,3/25/2024 9:45,135,156,45
205,6/24/2024,3,3,5339262,16,6/24/2024 14:00,87,103,45
297,4/26/2024,1,2,4463529,17,4/26/2024 4:05,72,89,45
222,6/13/2024,1,3,3262876,10,6/13/2024 3:50,57,67,46
384,3/1/2024,3,1,798104,10,3/1/2024 14:11,26,36,46
21,10/18/2024,3,1,584761,32,10/18/2024 13:57,18,50,46
33,10/11/2024,1,1,423677,12,10/11/2024 3:37,17,29,46
57,9/26/2024,1,1,80220,22,9/26/2024 3:47,12,34,46
354,3/21/2024,1,3,5844853,16,3/21/2024 4:00,94,110,47
55,9/27/2024,1,3,3614532,16,9/27/2024 4:01,66,82,47
139,8/5/2024,3,2,5383114,15,8/5/2024 14:04,96,111,48
52,9/30/2024,1,3,7461603,14,9/30/2024 4:24,125,139,49
278,5/8/2024,3,3,6711402,35,5/8/2024 14:55,107,142,49
204,6/25/2024,1,3,6009558,13,6/25/2024 4:02,106,119,49
88,9/6/2024,1,1,1043289,19,9/6/2024 3:44,26,45,49
277,5/9/2024,1,3,6464234,22,5/9/2024 4:16,102,124,50
264,5/17/2024,1,3,6069317,16,5/17/2024 4:06,104,120,50
110,8/23/2024,1,1,525538,20,8/23/2024 3:45,18,38,50
63,9/23/2024,1,3,6790845,13,9/23/2024 4:23,113,126,51
107,8/26/2024,1,3,7406459,15,8/26/2024 4:30,119,134,52
118,8/19/2024,1,4,9198286,14,8/19/2024 4:39,140,154,53
279,5/8/2024,1,3,6857457,13,5/8/2024 4:05,113,126,53
83,9/10/2024,1,4,9093305,25,9/10/2024 4:39,141,166,54
171,7/16/2024,1,4,8778209,17,7/16/2024 4:30,137,154,54
285,5/3/2024,3,3,6252562,16,5/3/2024 14:03,96,112,54
61,9/24/2024,1,5,9751274,18,9/24/2024 4:37,151,169,55
325,4/9/2024,1,4,9101101,18,4/9/2024 4:40,135,153,55
294,4/29/2024,1,3,8863095,15,4/29/2024 4:33,130,145,55
17,10/22/2024,1,5,9649586,25,10/22/2024 4:44,153,178,56
338,4/1/2024,1,3,8594820,15,4/1/2024 8:48,127,142,56
268,5/15/2024,1,3,8020731,13,5/15/2024 4:23,125,138,56
266,5/16/2024,1,3,6799164,11,5/16/2024 4:07,106,117,56
129,8/12/2024,1,4,7587320,15,8/12/2024 4:35,127,142,58
96,9/2/2024,1,4,10295176,18,9/2/2024 4:52,156,174,59
105,8/27/2024,1,5,9889372,20,8/27/2024 4:35,158,178,59
193,7/2/2024,1,4,9049608,15,7/2/2024 8:20,139,154,59
227,6/10/2024,3,4,8013138,20,6/10/2024 14:18,123,143,59
6,10/29/2024,1,5,11754361,24,10/29/2024 4:53,181,205,60
94,9/3/2024,1,6,10834720,18,9/3/2024 4:37,166,184,60
261,5/20/2024,1,4,8422511,15,5/20/2024 4:44,128,143,60
304,4/22/2024,3,3,6177234,18,4/22/2024 17:28,102,120,60
85,9/9/2024,1,5,10201291,19,9/9/2024 4:53,154,173,61
308,4/19/2024,1,1,510773,25,4/19/2024 3:43,16,41,61
237,6/4/2024,1,6,9960619,20,6/4/2024 4:35,154,174,62
382,3/4/2024,1,3,6260931,14,3/4/2024 4:09,139,153,62
271,5/13/2024,3,3,8516880,18,5/13/2024 14:23,132,150,63
64,9/21/2024,1,6,12660975,18,9/21/2024 8:57,190,208,64
148,7/30/2024,3,5,10267327,20,7/30/2024 20:25,159,179,64
347,3/26/2024,1,5,9491361,22,3/26/2024 4:24,139,161,64
235,6/5/2024,1,3,6784796,13,6/5/2024 3:46,111,124,64
43,10/4/2024,3,6,10722842,22,10/4/2024 14:46,162,184,65
380,3/5/2024,1,5,9573018,20,3/5/2024 4:28,193,213,65
116,8/20/2024,1,6,12241120,20,8/20/2024 4:55,184,204,66
159,7/23/2024,3,5,11185834,24,7/23/2024 15:46,170,194,66
303,4/23/2024,1,5,10117386,19,4/23/2024 4:42,154,173,66
151,7/29/2024,1,4,9264940,26,7/29/2024 7:50,140,166,66
248,5/28/2024,1,5,11684193,18,5/28/2024 4:37,175,193,67
192,7/2/2024,3,5,11659968,25,7/2/2024 14:53,177,202,67
188,7/4/2024,3,5,11765346,24,7/4/2024 14:52,174,198,68
314,4/16/2024,1,5,10907499,21,4/16/2024 4:38,159,180,68
358,3/19/2024,1,6,10768830,25,3/19/2024 4:37,158,183,69
30,10/14/2024,1,5,12856980,21,10/14/2024 5:05,189,210,70
149,7/30/2024,1,5,11995579,21,7/30/2024 5:00,178,199,70
181,7/9/2024,3,5,11336608,27,7/9/2024 14:55,172,199,70
66,9/20/2024,1,3,3904774,26,9/20/2024 4:11,68,94,70
29,10/14/2024,3,6,11730010,22,10/14/2024 17:02,230,252,71
250,5/27/2024,1,5,11280297,20,5/27/2024 9:51,167,187,71
360,3/18/2024,1,5,11185128,21,3/18/2024 4:43,160,181,71
51,9/30/2024,3,5,9161652,21,9/30/2024 14:35,136,157,71
316,4/15/2024,1,5,10784742,22,4/15/2024 4:54,154,176,72
369,3/12/2024,1,5,9838752,20,3/12/2024 4:24,144,164,72
18,10/21/2024,3,4,9129684,27,10/21/2024 16:19,146,173,72
371,3/11/2024,3,4,8840451,18,3/11/2024 19:47,131,149,72
126,8/13/2024,3,5,12319205,53,8/13/2024 15:22,185,238,73
160,7/23/2024,1,6,12239026,22,7/23/2024 4:52,184,206,73
215,6/18/2024,1,6,11366312,21,6/18/2024 4:49,168,189,73
184,7/8/2024,1,5,13297560,20,7/8/2024 10:39,201,221,75
7,10/28/2024,3,5,10453122,22,10/28/2024 16:31,157,179,75
203,6/25/2024,3,1,400080,9,6/25/2024 14:55,174,183,75
41,10/7/2024,1,7,14635811,25,10/7/2024 5:34,231,256,77
62,9/23/2024,3,5,10151809,22,9/23/2024 14:47,148,170,77
259,5/21/2024,1,7,14118516,23,5/21/2024 5:17,207,230,78
28,10/15/2024,1,6,13711279,30,10/15/2024 9:39,209,239,78
27,10/15/2024,3,6,13585998,34,10/15/2024 15:19,204,238,78
195,7/1/2024,1,4,9651916,15,7/1/2024 9:14,147,162,78
239,6/3/2024,1,5,13686279,23,6/3/2024 5:05,201,224,79
258,5/21/2024,3,6,13033777,30,5/21/2024 15:09,195,225,80
247,5/28/2024,3,6,12983994,26,5/28/2024 15:05,196,222,82
172,7/15/2024,3,6,12225733,25,7/15/2024 14:53,177,202,82
93,9/3/2024,3,5,12181407,23,9/3/2024 20:49,178,201,82
104,8/27/2024,3,6,13336744,27,8/27/2024 15:11,203,230,83
225,6/11/2024,3,6,12917669,27,6/11/2024 16:16,193,220,85
91,9/4/2024,3,6,12157570,23,9/4/2024 17:51,186,209,85
128,8/12/2024,3,6,10180319,28,8/12/2024 14:57,185,213,88
281,5/7/2024,1,6,13965480,26,5/7/2024 4:43,203,229,89
106,8/26/2024,3,7,13871819,28,8/26/2024 15:07,197,225,89
273,5/11/2024,1,5,13647770,26,5/11/2024 9:04,197,223,89
114,8/21/2024,1,5,10021737,30,8/21/2024 4:20,152,182,89
212,6/19/2024,3,1,1491879,40,6/19/2024 15:15,31,71,90
327,4/8/2024,1,6,14611513,31,4/8/2024 5:28,207,238,92
346,3/26/2024,3,6,14270664,34,3/26/2024 15:11,208,242,93
82,9/10/2024,3,6,12683943,26,9/10/2024 14:55,196,222,93
331,4/4/2024,3,6,12146504,29,4/4/2024 15:00,175,204,94
182,7/9/2024,1,7,17668006,30,7/9/2024 4:58,257,287,96
270,5/14/2024,1,7,16080412,30,5/14/2024 5:24,235,265,97
381,3/4/2024,3,7,15042438,34,3/4/2024 15:40,298,332,97
127,8/13/2024,1,7,12841259,28,8/13/2024 9:06,159,187,97
280,5/7/2024,3,7,14907119,36,5/7/2024 15:18,216,252,100
324,4/9/2024,3,7,14712248,38,4/9/2024 15:47,210,248,100
50,10/1/2024,1,7,12863983,29,10/1/2024 8:47,195,224,100
140,8/5/2024,1,8,16621140,26,8/5/2024 5:19,246,272,101
60,9/24/2024,3,6,14754275,31,9/24/2024 15:30,220,251,102
335,4/2/2024,3,6,14496079,37,4/2/2024 16:34,205,242,102
357,3/19/2024,3,7,14423910,34,3/19/2024 16:05,708,742,102
310,4/18/2024,1,1,994837,21,4/18/2024 3:39,23,44,102
260,5/20/2024,3,8,17675362,34,5/20/2024 15:08,268,302,104
379,3/5/2024,3,7,16909698,44,3/5/2024 15:56,336,380,104
368,3/12/2024,3,6,15739167,36,3/12/2024 15:19,226,262,104
49,10/1/2024,3,6,14134568,52,10/1/2024 15:41,212,264,105
16,10/22/2024,3,6,13308993,25,10/22/2024 15:04,206,231,105
226,6/11/2024,1,8,17059588,30,6/11/2024 4:58,256,286,107
313,4/16/2024,3,7,16793088,49,4/16/2024 15:45,239,288,108
269,5/14/2024,3,7,17464039,47,5/14/2024 15:37,259,306,111
5,10/29/2024,3,8,14990562,30,10/29/2024 15:19,226,256,113
137,8/6/2024,3,9,21351966,68,8/6/2024 16:53,313,381,115
291,4/30/2024,3,8,17393954,40,4/30/2024 15:11,252,292,115
162,7/22/2024,1,10,24891953,43,7/22/2024 6:45,358,401,117
115,8/20/2024,3,10,19136215,37,8/20/2024 16:31,283,320,119
117,8/19/2024,3,7,14132479,28,8/19/2024 15:07,206,234,120
292,4/30/2024,1,10,19129056,41,4/30/2024 5:33,275,316,121
302,4/23/2024,3,7,14954548,66,4/23/2024 15:53,220,286,126
236,6/4/2024,3,10,20534888,42,6/4/2024 16:20,297,339,128
39,10/8/2024,1,10,25769018,43,10/8/2024 6:41,192,235,133
214,6/18/2024,3,9,23313942,47,6/18/2024 15:34,338,385,133
72,9/17/2024,1,10,22657633,40,9/17/2024 6:19,333,373,137
19,10/21/2024,1,10,25898806,45,10/21/2024 6:48,380,425,141
283,5/6/2024,1,10,23116087,49,5/6/2024 5:56,335,384,144
305,4/22/2024,1,10,24427055,54,4/22/2024 11:21,350,404,155
71,9/17/2024,3,6,16567494,45,9/17/2024 21:57,243,288,162
138,8/6/2024,1,10,21438124,57,8/6/2024 6:30,318,375,182
38,10/8/2024,3,6,15379836,42,10/8/2024 16:12,226,268,333
170,7/16/2024,3,6,12959984,26,7/16/2024 15:05,197,223,755
690,8/21/2023,1,10,25385591,56,8/21/2023 6:12,250,306,0
401,2/20/2024,3,10,22420181,60,2/20/2024 16:16,435,495,0
489,12/26/2023,3,9,22078460,52,12/26/2023 15:48,424,476,0
764,7/4/2023,3,10,22034702,10,7/4/2023 19:55,408,418,0
524,12/4/2023,3,10,21954126,55,12/4/2023 15:46,359,414,0
569,11/6/2023,1,8,21341821,46,11/6/2023 6:08,413,459,0
478,1/2/2024,3,10,21223271,55,1/2/2024 19:09,350,405,0
500,12/19/2023,3,9,20655681,27,12/19/2023 16:20,396,423,0
831,5/23/2023,1,8,19946572,81,5/23/2023 7:48,369,450,0
786,6/20/2023,3,10,19370699,36,6/20/2023 15:52,369,405,0
665,9/5/2023,3,8,19227745,46,9/5/2023 15:35,315,361,0
445,1/23/2024,3,9,19111182,76,1/23/2024 16:51,372,448,0
566,11/7/2023,3,9,19077358,49,11/7/2023 16:06,368,417,0
843,5/15/2023,3,8,18764369,31,5/15/2023 14:32,371,402,0
761,7/6/2023,1,7,18693240,40,7/6/2023 5:52,344,384,0
546,11/20/2023,3,9,18671044,46,11/20/2023 19:12,358,402,0
511,12/12/2023,3,8,18555081,45,12/12/2023 15:52,300,345,0
456,1/16/2024,3,8,18541468,43,1/16/2024 15:41,359,402,0
448,1/22/2024,1,7,18086055,40,1/22/2024 5:32,355,395,0
544,11/21/2023,3,7,17832616,41,11/21/2023 15:44,344,385,0
808,6/6/2023,3,8,17548448,32,6/6/2023 15:28,338,370,0
643,9/19/2023,3,8,17291694,42,9/19/2023 15:29,334,376,0
588,10/24/2023,3,8,17148204,54,10/24/2023 15:43,336,390,0
426,2/5/2024,1,9,17144015,42,2/5/2024 6:19,335,377,0
852,5/9/2023,3,7,16847972,29,5/9/2023 15:25,324,353,0
577,10/31/2023,3,7,16842469,33,10/31/2023 16:28,329,362,0
555,11/14/2023,3,7,16801119,39,11/14/2023 15:47,325,364,0
819,5/30/2023,3,7,16743417,29,5/30/2023 15:26,326,355,0
610,10/10/2023,3,8,16719460,41,10/10/2023 15:39,323,364,0
599,10/17/2023,3,7,16710488,42,10/17/2023 15:46,328,370,0
654,9/12/2023,3,7,16604257,41,9/12/2023 15:32,320,361,0
720,8/1/2023,3,8,16596173,37,8/1/2023 15:33,321,358,0
797,6/13/2023,3,8,16592295,30,6/13/2023 18:19,323,353,0
841,5/16/2023,3,8,16511981,34,5/16/2023 15:20,320,354,0
698,8/15/2023,3,7,16441419,22,8/15/2023 19:52,317,339,0
731,7/25/2023,3,7,16390999,39,7/25/2023 15:21,319,358,0
676,8/29/2023,3,7,16306905,25,8/29/2023 15:27,320,345,0
830,5/23/2023,3,8,16297235,29,5/23/2023 17:28,312,341,0
863,5/2/2023,3,7,16273660,28,5/2/2023 15:14,318,346,0
424,2/6/2024,1,8,16201967,41,2/6/2024 5:04,320,361,0
412,2/13/2024,3,8,16201610,41,2/13/2024 15:33,313,354,0
621,10/3/2023,3,7,16128129,42,10/3/2023 15:33,314,356,0
709,8/8/2023,3,7,16050168,34,8/8/2023 15:21,314,348,0
434,1/30/2024,3,8,16035718,38,1/30/2024 17:21,315,353,0
687,8/22/2023,3,7,16006989,35,8/22/2023 15:22,312,347,0
613,10/9/2023,1,6,16004064,33,10/9/2023 8:00,306,339,0
632,9/26/2023,3,7,15702705,38,9/26/2023 15:16,334,372,0
775,6/27/2023,3,7,15265552,35,6/27/2023 19:58,294,329,0
743,7/18/2023,1,7,15161965,32,7/18/2023 4:59,295,327,0
667,9/4/2023,3,7,15069444,49,9/4/2023 15:06,291,340,0
423,2/6/2024,3,6,15014562,65,2/6/2024 16:30,292,357,0
533,11/28/2023,3,8,14680864,39,11/28/2023 15:11,287,326,0
833,5/22/2023,1,6,14544841,22,5/22/2023 11:28,286,308,0
739,7/20/2023,1,6,14137993,33,7/20/2023 5:19,277,310,0
390,2/27/2024,3,6,13734221,67,2/27/2024 15:44,271,338,0
679,8/28/2023,1,6,13135081,26,8/28/2023 4:59,267,293,0
467,1/9/2024,3,7,13076677,34,1/9/2024 15:08,258,292,0
700,8/14/2023,3,6,12849753,30,8/15/2023 9:29,248,278,0
469,1/8/2024,3,6,12721141,30,1/8/2024 14:53,248,278,0
811,6/5/2023,1,6,12646313,23,6/5/2023 5:00,239,262,0
522,12/5/2023,3,5,12510396,29,12/5/2023 15:01,251,280,0
733,7/24/2023,3,5,12481690,20,7/24/2023 15:07,230,250,0
435,1/30/2024,1,5,12182252,27,1/30/2024 4:40,264,291,0
712,8/7/2023,1,5,12096174,22,8/7/2023 4:40,239,261,0
589,10/24/2023,1,5,11926035,26,10/24/2023 4:35,233,259,0
859,5/4/2023,3,6,11901537,21,5/4/2023 14:43,232,253,0
785,6/21/2023,1,5,11873962,21,6/21/2023 4:18,231,252,0
865,5/1/2023,3,5,11809560,21,5/1/2023 14:43,228,249,0
714,8/4/2023,3,5,11769914,23,8/4/2023 14:35,229,252,0
645,9/18/2023,3,5,11764233,28,9/19/2023 1:38,227,255,0
547,11/20/2023,1,4,11382370,41,11/20/2023 12:41,221,262,0
503,12/18/2023,1,6,11355400,27,12/18/2023 4:35,224,251,0
624,10/2/2023,1,5,11177610,24,10/2/2023 9:22,220,244,0
498,12/20/2023,3,5,11154980,26,12/20/2023 14:49,224,250,0
619,10/4/2023,3,5,11009659,27,10/4/2023 14:39,217,244,0
521,12/6/2023,1,5,11002763,23,12/6/2023 4:58,218,241,0
402,2/20/2024,1,6,10961014,24,2/20/2024 4:37,217,241,0
809,6/6/2023,1,4,10952576,18,6/6/2023 4:30,208,226,0
738,7/20/2023,3,6,10762240,26,7/20/2023 14:38,217,243,0
641,9/20/2023,3,5,10698393,25,9/20/2023 14:45,213,238,0
753,7/11/2023,3,5,10523997,25,7/11/2023 14:43,217,242,0
474,1/4/2024,3,5,10482857,24,1/4/2024 14:36,212,236,0
446,1/23/2024,1,5,10102332,22,1/23/2024 4:51,206,228,0
635,9/25/2023,1,4,10096948,22,9/25/2023 4:49,197,219,0
413,2/13/2024,1,5,10058738,21,2/13/2024 4:29,202,223,0
756,7/10/2023,1,4,9949294,18,7/10/2023 4:46,188,206,0
391,2/27/2024,1,6,9872199,11,2/27/2024 4:28,196,207,0
415,2/12/2024,1,4,9630020,18,2/12/2024 9:27,195,213,0
602,10/16/2023,1,4,9627145,26,10/16/2023 4:38,190,216,0
404,2/19/2024,1,4,9359727,21,2/19/2024 4:44,186,207,0
740,7/19/2023,3,5,9181036,20,7/19/2023 14:47,186,206,0
822,5/29/2023,1,4,9170300,15,5/29/2023 4:32,177,192,0
536,11/27/2023,1,4,8823207,19,11/27/2023 4:26,175,194,0
437,1/29/2024,1,3,8568350,15,1/29/2024 12:32,176,191,0
668,9/4/2023,1,4,8319010,20,9/4/2023 4:20,169,189,0
579,10/30/2023,3,4,8159486,45,10/30/2023 14:48,165,210,0
800,6/12/2023,1,3,8075093,20,6/12/2023 5:29,163,183,0
514,12/11/2023,1,4,8000570,18,12/11/2023 4:26,161,179,0
593,10/20/2023,3,5,7902593,23,10/20/2023 16:41,167,190,0
722,7/31/2023,3,3,7528460,16,,164,180,0
855,5/8/2023,1,3,7528164,13,5/8/2023 4:20,160,173,0
558,11/13/2023,1,3,7289390,16,11/13/2023 4:18,153,169,0
713,8/5/2023,1,5,7125873,15,8/5/2023 4:07,151,166,0
578,10/31/2023,1,3,6659412,25,10/31/2023 4:18,149,174,0
592,10/21/2023,1,5,6584598,18,10/21/2023 4:32,141,159,0
622,10/3/2023,1,3,6514670,15,10/3/2023 6:20,145,160,0
400,2/21/2024,1,5,6452519,16,2/21/2024 10:39,146,162,0
789,6/19/2023,1,3,6452084,18,6/19/2023 4:15,133,151,0
655,9/12/2023,1,3,6268939,16,9/12/2023 3:52,135,151,0
393,2/26/2024,1,3,6082632,15,2/26/2024 9:04,139,154,0
644,9/19/2023,1,3,5967982,14,9/19/2023 5:39,131,145,0
512,12/12/2023,1,3,5928683,14,12/12/2023 4:03,136,150,0
776,6/27/2023,1,3,5907420,14,6/27/2023 15:58,135,149,0
618,10/5/2023,1,3,5735702,12,10/5/2023 3:58,126,138,0
842,5/16/2023,1,3,5720880,11,5/16/2023 2:58,131,142,0
763,7/5/2023,1,3,5710593,11,7/5/2023 7:10,116,127,0
798,6/13/2023,1,1,5708878,19,6/13/2023 4:06,132,151,0
488,12/27/2023,1,3,5504484,16,12/27/2023 3:39,121,137,0
556,11/14/2023,1,2,5493523,12,11/14/2023 3:57,126,138,0
653,9/13/2023,1,2,5487888,12,9/13/2023 3:54,122,134,0
490,12/26/2023,1,2,5468967,12,12/26/2023 3:55,129,141,0
666,9/5/2023,1,3,5441592,13,9/5/2023 3:56,120,133,0
788,6/19/2023,3,2,5385533,30,6/19/2023 15:18,120,150,0
820,5/30/2023,1,2,5319983,9,5/30/2023 6:20,124,133,0
864,5/2/2023,1,3,5316300,11,5/2/2023 3:58,123,134,0
787,6/20/2023,1,3,5303371,11,6/20/2023 3:59,112,123,0
750,7/13/2023,1,3,5242604,11,7/13/2023 3:54,104,115,0
523,12/5/2023,1,3,5234045,12,12/5/2023 3:56,116,128,0
656,9/11/2023,3,2,5194572,14,9/11/2023 14:02,117,131,0
732,7/25/2023,1,3,5171286,12,7/25/2023 3:54,130,142,0
392,2/26/2024,3,3,5146714,15,2/26/2024 13:53,115,130,0
633,9/26/2023,1,3,5098258,12,9/26/2023 3:56,113,125,0
534,11/28/2023,1,2,5090458,12,11/28/2023 3:51,123,135,0
468,1/9/2024,1,2,5021746,13,1/9/2024 3:56,120,133,0
765,7/4/2023,1,3,4947284,10,7/4/2023 3:53,110,120,0
600,10/17/2023,1,2,4874794,24,10/17/2023 4:03,118,142,0
754,7/11/2023,1,2,4722903,11,7/11/2023 3:54,113,124,0
447,1/22/2024,3,2,4720656,15,1/22/2024 14:04,104,119,0
688,8/22/2023,1,2,4708994,9,8/22/2023 3:53,114,123,0
501,12/19/2023,1,2,4690474,20,12/19/2023 3:58,103,123,0
799,6/12/2023,3,3,4687233,36,6/12/2023 14:19,101,137,0
710,8/8/2023,1,2,4677174,9,8/8/2023 3:53,112,121,0
545,11/21/2023,1,2,4609616,15,11/21/2023 4:39,105,120,0
642,9/20/2023,1,3,4525433,11,9/20/2023 3:50,99,110,0
553,11/15/2023,3,3,4495442,13,11/15/2023 13:52,99,112,0
479,1/2/2024,1,3,4452248,13,1/2/2024 3:52,98,111,0
459,1/15/2024,1,2,4321508,12,1/15/2024 3:55,95,107,0
497,12/21/2023,1,3,4112772,16,12/21/2023 3:51,96,112,0
723,7/31/2023,1,2,3981490,9,,89,98,0
425,2/5/2024,3,2,3966815,14,2/5/2024 14:40,111,125,0
557,11/13/2023,3,2,3947960,14,11/13/2023 13:57,90,104,0
611,10/10/2023,1,2,3946416,13,10/10/2023 3:48,90,103,0
677,8/29/2023,1,2,3929567,8,8/29/2023 3:47,92,100,0
567,11/7/2023,1,2,3911393,11,11/7/2023 3:49,88,99,0
752,7/12/2023,1,3,3884289,9,7/12/2023 3:53,89,98,0
699,8/15/2023,1,2,3796192,12,8/15/2023 16:35,86,98,0
737,7/21/2023,1,2,3607699,22,7/21/2023 3:59,99,121,0
853,5/9/2023,1,2,3557128,9,5/9/2023 3:46,82,91,0
774,6/28/2023,1,2,3534640,11,6/28/2023 4:19,102,113,0
721,8/1/2023,1,2,3472133,8,8/1/2023 8:50,80,88,0
458,1/15/2024,3,2,3428047,13,1/15/2024 13:41,82,95,0
689,8/21/2023,3,2,3405521,9,8/21/2023 20:21,88,97,0
854,5/8/2023,3,2,3349951,9,5/8/2023 13:46,75,84,0
513,12/11/2023,3,2,3300956,13,12/11/2023 13:43,75,88,0
631,9/27/2023,1,2,3294561,10,9/27/2023 3:42,75,85,0
454,1/17/2024,3,3,3215221,13,1/17/2024 15:01,78,91,0
840,5/17/2023,1,2,3212624,15,5/17/2023 3:58,66,81,0
640,9/21/2023,1,2,3006699,8,9/21/2023 3:41,69,77,0
499,12/20/2023,1,2,3001296,24,12/20/2023 3:53,70,94,0
657,9/11/2023,1,1,2849327,8,9/11/2023 3:42,72,80,0
693,8/18/2023,1,1,2773893,8,8/18/2023 3:36,84,92,0
466,1/10/2024,1,1,2763606,11,1/10/2024 3:39,69,80,0
403,2/19/2024,3,1,2748575,46,2/19/2024 14:18,71,117,0
777,6/26/2023,3,1,2702486,9,6/26/2023 13:41,61,70,0
473,1/5/2024,1,1,2691023,8,1/5/2024 3:37,67,75,0
729,7/26/2023,3,1,2689903,8,7/26/2023 14:55,64,72,0
502,12/18/2023,3,1,2612432,35,12/18/2023 14:04,72,105,0
472,1/5/2024,3,1,2559129,41,1/5/2024 14:11,72,113,0
551,11/16/2023,3,1,2394951,12,11/17/2023 3:31,18,30,0
481,1/1/2024,1,1,2222170,6,1/1/2024 15:58,61,67,0
436,1/29/2024,3,1,2134641,11,1/29/2024 15:39,46,57,0
857,5/5/2023,3,1,2115651,8,5/5/2023 13:36,63,71,0
858,5/5/2023,1,1,2059858,6,5/5/2023 3:33,71,77,0
477,1/3/2024,1,1,1970444,6,1/3/2024 14:37,61,67,0
792,6/16/2023,1,1,1948440,14,6/16/2023 3:42,72,86,0
638,9/22/2023,1,1,1845007,11,9/22/2023 3:34,67,78,0
802,6/9/2023,3,1,1762763,7,6/9/2023 13:34,66,73,0
715,8/4/2023,1,1,1736713,6,8/4/2023 3:34,64,70,0
836,5/19/2023,1,1,1726949,18,5/19/2023 3:51,64,82,0
810,6/5/2023,3,1,1700906,31,6/5/2023 14:04,57,88,0
591,10/23/2023,1,1,1697736,7,10/23/2023 3:30,44,51,0
704,8/11/2023,1,1,1647205,6,8/11/2023 3:30,63,69,0
835,5/19/2023,3,1,1632322,31,5/19/2023 13:59,39,70,0
439,1/26/2024,3,1,1630492,9,1/26/2024 13:32,42,51,0
824,5/26/2023,3,1,1614286,7,5/26/2023 13:35,42,49,0
825,5/26/2023,1,1,1608055,13,5/26/2023 5:44,58,71,0
862,5/3/2023,1,1,1604099,5,5/3/2023 3:28,41,46,0
461,1/12/2024,3,1,1596421,11,1/12/2024 13:35,43,54,0
649,9/15/2023,1,1,1588855,6,9/15/2023 8:08,64,72,0
814,6/2/2023,1,1,1584836,6,6/2/2023 3:33,68,74,0
701,8/14/2023,1,1,1559653,5,8/14/2023 3:39,41,46,0
660,9/8/2023,1,1,1547695,10,9/8/2023 3:34,71,81,0
748,7/14/2023,1,1,1546395,13,7/14/2023 3:42,62,75,0
717,8/3/2023,1,1,1539592,5,8/3/2023 3:28,42,47,0
781,6/23/2023,1,1,1526241,5,6/23/2023 3:33,66,71,0
487,12/27/2023,3,1,1496783,9,12/27/2023 13:33,40,49,0
584,10/26/2023,3,1,1488548,12,10/26/2023 13:35,40,52,0
772,6/29/2023,1,1,1475301,9,6/29/2023 3:37,39,48,0
606,10/12/2023,3,1,1447564,9,10/12/2023 13:32,40,49,0
812,6/3/2023,1,1,1432743,17,6/3/2023 3:40,37,54,0
672,8/31/2023,3,1,1424071,7,8/31/2023 13:31,58,65,0
846,5/12/2023,3,1,1392223,6,5/12/2023 12:34,36,42,0
429,2/2/2024,1,1,1352339,6,2/2/2024 3:26,41,47,0
598,10/18/2023,1,1,1320368,7,10/18/2023 3:25,36,43,0
727,7/27/2023,3,1,1311447,32,7/27/2023 13:55,55,87,0
670,9/1/2023,3,1,1291142,28,9/1/2023 14:09,38,66,0
595,10/19/2023,3,1,1280825,11,10/19/2023 13:52,37,48,0
572,11/3/2023,1,1,1276264,7,11/3/2023 3:26,36,43,0
659,9/8/2023,3,1,1269037,10,9/8/2023 13:31,33,43,0
845,5/13/2023,1,1,1252643,5,5/13/2023 2:33,55,60,0
406,2/16/2024,3,1,1250386,11,2/16/2024 13:34,37,48,0
470,1/8/2024,1,1,1207508,7,1/8/2024 3:30,34,41,0
395,2/23/2024,3,1,1160689,9,2/23/2024 13:27,34,33,0
476,1/3/2024,3,1,1158845,8,1/3/2024 15:45,27,35,0
484,12/29/2023,1,1,1135232,6,12/29/2023 3:30,38,44,0
450,1/19/2024,3,1,1129086,9,1/19/2024 13:43,32,41,0
568,11/6/2023,3,1,1086406,12,11/6/2023 16:34,31,43,0
617,10/5/2023,3,1,1070079,9,10/5/2023 13:32,38,47,0
637,9/22/2023,3,1,1045978,8,9/22/2023 15:49,39,47,0
451,1/19/2024,1,1,1006782,8,1/19/2024 3:27,31,39,0
696,8/16/2023,3,1,975130,6,8/16/2023 13:30,33,39,0
414,2/12/2024,3,1,974430,8,2/12/2024 14:26,29,37,0
767,7/3/2023,1,1,974099,4,7/3/2023 3:28,30,34,0
582,10/27/2023,3,1,966540,12,10/27/2023 13:31,30,42,0
453,1/18/2024,1,1,945179,6,1/18/2024 3:25,28,34,0
834,5/20/2023,1,1,883992,5,5/20/2023 10:43,22,27,0
571,11/3/2023,3,1,867118,12,11/3/2023 13:30,28,40,0
604,10/13/2023,3,1,862316,10,10/13/2023 13:28,26,36,0
762,7/5/2023,3,1,810712,6,7/5/2023 13:48,31,37,0
803,6/9/2023,1,1,802894,7,6/9/2023 3:30,26,33,0
396,2/23/2024,1,1,797582,16,2/23/2024 3:34,26,42,0
561,11/10/2023,1,1,794542,15,11/10/2023 3:36,26,41,0
838,5/18/2023,1,1,775319,5,5/18/2023 3:27,24,29,0
428,2/2/2024,3,1,767631,10,2/2/2024 13:28,25,35,0
517,12/8/2023,1,1,759063,7,12/8/2023 3:26,35,42,0
449,1/20/2024,1,1,716938,5,1/20/2024 3:24,24,29,0
741,7/19/2023,1,1,716784,6,7/19/2023 3:34,26,32,0
548,11/18/2023,1,1,713321,6,11/20/2023 8:41,237,243,0
669,9/2/2023,1,1,703118,8,9/2/2023 3:26,25,33,0
594,10/20/2023,1,1,696471,9,10/20/2023 3:28,24,33,0
601,10/16/2023,3,1,652605,33,10/16/2023 13:51,25,58,0
528,12/1/2023,1,1,646858,10,12/1/2023 9:02,23,33,0
791,6/16/2023,3,1,644353,7,6/16/2023 13:30,24,31,0
494,12/22/2023,3,1,639253,10,12/22/2023 13:29,23,33,0
691,8/19/2023,1,1,637011,4,8/19/2023 3:28,21,25,0
505,12/15/2023,3,1,635388,9,12/15/2023 13:29,22,31,0
408,2/15/2024,3,1,620046,9,2/15/2024 13:28,30,39,0
760,7/6/2023,3,1,618309,5,7/6/2023 14:54,26,31,0
573,11/2/2023,3,1,618013,11,11/2/2023 13:29,25,36,0
417,2/9/2024,3,1,615079,11,2/9/2024 13:29,18,29,0
648,9/15/2023,3,1,612215,11,9/15/2023 13:25,23,34,0
506,12/15/2023,1,1,600542,9,12/15/2023 3:27,28,37,0
549,11/17/2023,3,1,600178,10,11/18/2023 3:24,24,34,0
837,5/18/2023,3,1,589858,6,5/18/2023 13:29,21,27,0
526,12/2/2023,1,1,583222,6,12/2/2023 3:24,25,31,0
422,2/7/2024,1,1,574874,15,2/7/2024 3:33,20,35,0
630,9/27/2023,3,1,569573,10,9/27/2023 13:28,27,37,0
626,9/29/2023,3,1,569267,10,9/29/2023 13:26,21,31,0
516,12/8/2023,3,1,564248,10,12/8/2023 13:28,20,30,0
427,2/3/2024,1,1,542439,6,2/3/2024 3:24,22,28,0
745,7/17/2023,1,1,537687,4,7/17/2023 10:40,23,27,0
703,8/11/2023,3,1,536752,6,8/11/2023 13:25,19,25,0
525,12/4/2023,1,1,535366,6,12/4/2023 3:24,22,28,0
527,12/1/2023,3,1,521157,7,12/1/2023 14:48,19,26,0
673,8/31/2023,1,1,521157,4,8/31/2023 3:23,21,25,0
817,5/31/2023,3,1,516095,6,5/31/2023 13:29,20,26,0
692,8/18/2023,3,1,512475,6,8/18/2023 13:25,19,25,0
829,5/24/2023,1,1,510904,4,5/24/2023 3:27,20,24,0
736,7/21/2023,3,1,505217,32,7/21/2023 1:55,34,66,0
532,11/29/2023,1,1,489955,7,11/29/2023 3:25,19,26,0
780,6/23/2023,3,1,480915,5,6/23/2023 13:28,19,24,0
520,12/6/2023,3,1,479120,8,12/6/2023 13:32,20,28,0
706,8/10/2023,1,1,465330,4,8/10/2023 3:23,20,24,0
407,2/16/2024,1,1,464236,9,2/16/2024 3:27,20,29,0
747,7/14/2023,3,1,463431,29,7/14/2023 13:52,20,49,0
856,5/6/2023,1,1,447907,4,5/6/2023 3:27,16,20,0
646,9/18/2023,1,1,447666,4,9/18/2023 10:29,20,24,0
419,2/8/2024,3,1,437829,10,2/8/2024 13:25,15,25,0
560,11/10/2023,3,1,433524,32,11/10/2023 13:51,19,51,0
565,11/8/2023,1,1,431386,6,11/8/2023 3:25,18,24,0
801,6/10/2023,1,1,426534,13,6/10/2023 3:35,16,29,0
818,5/31/2023,1,1,413189,7,5/31/2023 3:30,17,24,0
636,9/23/2023,1,1,411894,5,9/23/2023 3:20,17,22,0
603,10/14/2023,1,1,410798,7,10/14/2023 3:23,18,25,0
440,1/26/2024,1,1,410266,10,1/26/2024 3:25,18,28,0
462,1/12/2024,1,1,407508,10,1/12/2024 9:44,20,30,0
431,2/1/2024,1,1,404615,5,2/1/2024 8:23,20,25,0
596,10/19/2023,1,1,401040,12,10/19/2023 3:30,19,31,0
726,7/28/2023,1,1,400902,6,7/28/2023 3:24,18,24,0
483,12/29/2023,3,1,399708,9,12/29/2023 13:28,18,27,0
742,7/18/2023,3,1,395424,6,7/18/2023 13:29,18,24,0
475,1/4/2024,1,1,383151,6,1/4/2024 3:25,17,23,0
711,8/7/2023,3,1,374049,6,8/7/2023 13:25,16,22,0
496,12/21/2023,3,1,367436,12,12/21/2023 13:28,20,32,0
662,9/7/2023,1,1,356515,5,9/7/2023 3:21,16,12,0
828,5/24/2023,3,1,352010,6,5/24/2023 13:29,16,22,0
768,7/1/2023,1,1,349710,3,7/1/2023 8:18,16,19,0
519,12/7/2023,1,1,346389,9,12/7/2023 3:28,17,26,0
430,2/1/2024,3,1,345385,9,2/1/2024 15:29,17,26,0
627,9/29/2023,1,1,343214,11,9/29/2023 3:27,17,28,0
671,9/1/2023,1,1,338757,15,9/1/2023 8:17,17,32,0
550,11/17/2023,1,1,337622,13,11/17/2023 13:28,22,35,0
813,6/2/2023,3,1,336637,5,6/2/2023 13:28,16,21,0
832,5/22/2023,3,1,329629,5,5/22/2023 16:19,10,15,0
826,5/25/2023,3,1,325137,5,5/25/2023 14:15,15,20,0
444,1/24/2024,1,1,322909,5,1/24/2024 3:23,20,25,0
847,5/12/2023,1,1,320095,4,5/12/2023 8:42,16,20,0
794,6/15/2023,1,1,318988,6,6/15/2023 3:29,16,22,0
682,8/25/2023,1,1,317646,4,8/25/2023 3:23,17,21,0
616,10/6/2023,1,1,307182,10,10/6/2023 3:26,38,48,0
495,12/22/2023,1,1,295486,10,12/22/2023 3:28,15,25,0
570,11/4/2023,1,1,290514,6,11/4/2023 3:25,17,23,0
782,6/22/2023,3,1,286756,6,6/22/2023 13:24,14,20,0
574,11/2/2023,1,1,285279,8,11/2/2023 9:18,18,26,0
540,11/23/2023,3,1,284895,35,11/23/2023 13:53,14,49,0
605,10/13/2023,1,1,284426,7,10/13/2023 3:23,17,24,0
664,9/6/2023,1,1,283345,6,9/6/2023 3:24,15,21,0
587,10/25/2023,1,1,276486,10,10/25/2023 3:26,16,26,0
485,12/28/2023,3,1,268922,9,12/28/2023 13:28,18,27,0
583,10/27/2023,1,1,267167,10,10/27/2023 3:29,16,26,0
725,7/28/2023,3,1,259168,6,7/28/2023 13:24,16,21,0
539,11/24/2023,1,1,258977,5,11/24/2023 3:23,15,20,0
770,6/30/2023,1,1,258463,5,6/30/2023 3:29,14,19,0
860,5/4/2023,1,1,258434,4,5/4/2023 3:26,14,28,0
634,9/25/2023,3,1,243777,7,9/25/2023 14:23,13,20,0
620,10/4/2023,1,1,243172,14,10/4/2023 3:32,14,28,0
821,5/29/2023,3,1,242676,5,5/29/2023 13:28,14,19,0
418,2/9/2024,1,1,242302,9,2/9/2024 3:30,22,31,0
615,10/6/2023,3,1,233961,9,10/6/2023 13:25,13,22,0
681,8/25/2023,3,1,233503,5,8/25/2023 13:24,13,18,0
465,1/10/2024,3,1,231785,10,1/10/2024 13:25,14,24,0
827,5/25/2023,1,1,229867,4,5/25/2023 3:22,14,18,0
759,7/7/2023,1,1,227700,3,7/7/2023 3:22,14,17,0
538,11/24/2023,3,1,220497,10,11/24/2023 13:27,13,23,0
749,7/13/2023,3,1,220169,6,7/13/2023 13:24,14,20,0
542,11/22/2023,3,1,219863,42,11/22/2023 13:57,14,56,0
629,9/28/2023,1,1,219827,10,9/28/2023 3:25,16,26,0
559,11/11/2023,1,1,218477,5,11/11/2023 3:19,14,19,0
433,1/31/2024,1,1,218476,5,1/31/2024 3:24,14,19,0
755,7/10/2023,3,1,213529,5,7/10/2023 13:29,16,21,0
399,2/21/2024,3,1,211497,8,2/21/2024 14:26,14,22,0
702,8/12/2023,1,1,209272,4,8/12/2023 3:23,14,18,0
758,7/7/2023,3,1,202913,5,7/7/2023 13:24,13,18,0
796,6/14/2023,1,1,201521,3,6/14/2023 8:43,12,15,0
492,12/25/2023,1,1,200053,6,12/25/2023 3:22,14,20,0
807,6/7/2023,1,1,195228,4,6/7/2023 3:27,12,16,0
678,8/28/2023,3,1,193703,5,8/28/2023 14:09,12,17,0
460,1/13/2024,1,1,190660,5,1/13/2024 3:24,13,18,0
405,2/17/2024,1,1,189747,6,2/17/2024 3:20,13,19,0
510,12/13/2023,1,1,189110,5,12/13/2023 3:24,13,18,0
518,12/7/2023,3,1,184880,7,12/7/2023 13:26,13,20,0
793,6/15/2023,3,1,183286,6,6/15/2023 13:24,14,20,0
719,8/2/2023,1,1,182707,4,8/2/2023 3:32,14,18,0
386,2/29/2024,3,1,179038,9,2/29/2024 13:25,14,23,0
410,2/14/2024,3,1,177348,10,2/14/2024 13:28,13,23,0
779,6/24/2023,1,1,176232,6,6/24/2023 4:14,13,19,0
623,10/2/2023,3,1,175610,11,10/2/2023 15:31,12,23,0
628,9/28/2023,3,1,167723,29,9/28/2023 13:44,13,42,0
463,1/11/2024,3,1,163331,8,1/11/2024 13:23,13,21,0
806,6/7/2023,3,1,159411,5,6/7/2023 13:28,12,17,0
686,8/23/2023,1,1,156046,4,8/23/2023 3:27,12,16,0
674,8/30/2023,3,1,149884,6,8/30/2023 13:59,12,18,0
443,1/24/2024,3,1,147629,9,1/24/2024 13:29,13,22,0
708,8/9/2023,1,1,146877,4,8/9/2023 3:22,12,16,0
861,5/3/2023,3,1,140306,6,5/3/2023 13:24,11,17,0
471,1/6/2024,1,1,139837,6,1/6/2024 3:21,12,18,0
530,11/30/2023,1,1,139557,5,11/30/2023 3:21,14,19,0
661,9/7/2023,3,1,137761,9,9/7/2023 13:29,12,21,0
707,8/9/2023,3,1,132486,6,8/9/2023 13:25,12,18,0
784,6/21/2023,3,1,132332,7,6/21/2023 13:30,12,19,0
694,8/17/2023,3,1,130846,6,8/17/2023 13:30,12,18,0
697,8/16/2023,1,1,129954,3,8/16/2023 4:17,11,14,0
769,6/30/2023,3,1,129792,5,6/30/2023 13:24,11,16,0
389,2/28/2024,1,1,129293,4,2/28/2024 3:22,13,17,0
823,5/27/2023,1,1,121897,3,5/27/2023 3:28,11,14,0
773,6/28/2023,3,1,120828,6,6/28/2023 13:24,11,17,0
757,7/8/2023,1,1,115702,3,7/8/2023 3:22,11,14,0
716,8/3/2023,3,1,110994,6,8/3/2023 13:24,11,17,0
421,2/7/2024,3,1,110572,9,2/7/2024 13:24,11,20,0
432,1/31/2024,3,1,107913,7,1/31/2024 13:23,11,18,0
850,5/10/2023,3,1,106150,5,5/10/2023 12:28,10,15,0
790,6/17/2023,1,1,105449,12,6/17/2023 3:35,11,23,0
563,11/9/2023,1,1,104966,5,11/9/2023 3:24,13,18,0
848,5/11/2023,3,1,101808,5,5/11/2023 12:23,10,15,0
562,11/9/2023,3,1,99812,9,11/9/2023 13:25,13,22,0
597,10/18/2023,3,1,99772,10,10/18/2023 13:24,11,21,0
586,10/25/2023,3,1,99621,9,10/25/2023 13:24,11,20,0
675,8/30/2023,1,1,99558,3,8/30/2023 3:22,14,17,0
746,7/15/2023,1,1,99243,4,7/15/2023 3:27,11,15,0
464,1/11/2024,1,1,97198,5,1/11/2024 3:21,13,18,0
795,6/14/2023,3,1,96591,6,6/14/2023 13:24,10,16,0
535,11/27/2023,3,1,96576,7,11/27/2023 13:23,11,18,0
612,10/9/2023,3,1,94293,10,10/9/2023 15:55,11,21,0
452,1/18/2024,3,1,94041,9,1/18/2024 13:24,12,21,0
455,1/17/2024,1,1,93460,6,1/17/2024 3:36,12,18,0
751,7/12/2023,3,1,90785,7,7/12/2023 13:25,11,18,0
529,11/30/2023,3,1,89105,9,11/30/2023 13:24,12,21,0
397,2/22/2024,3,1,88893,9,2/22/2024 13:24,12,21,0
839,5/17/2023,3,1,85563,5,5/17/2023 13:28,10,15,0
771,6/29/2023,3,1,84486,5,6/29/2023 13:24,11,16,0
815,6/1/2023,3,1,81582,5,6/1/2023 13:28,10,15,0
442,1/25/2024,1,1,79470,5,1/25/2024 3:21,12,17,0
580,10/30/2023,1,1,79031,14,10/30/2023 3:32,11,25,0
398,2/22/2024,1,1,75312,11,2/22/2024 3:27,11,22,0
441,1/25/2024,3,1,74944,9,1/25/2024 13:42,12,21,0
804,6/8/2023,3,1,73487,5,6/8/2023 13:23,10,15,0
783,6/22/2023,1,1,72701,13,6/22/2023 3:36,10,23,0
576,11/1/2023,1,1,71862,10,11/1/2023 10:07,11,21,0
650,9/14/2023,3,1,70176,7,9/14/2023 13:26,11,18,0
543,11/22/2023,1,1,69608,5,11/22/2023 3:23,11,16,0
554,11/15/2023,1,1,68806,13,11/15/2023 3:29,10,23,0
805,6/8/2023,1,1,68037,3,6/8/2023 3:26,11,14,0
695,8/17/2023,1,1,66046,4,8/17/2023 3:23,11,15,0
531,11/29/2023,3,1,64720,9,11/29/2023 13:25,10,19,0
486,12/28/2023,1,1,64717,6,12/28/2023 3:25,10,16,0
718,8/2/2023,3,1,62523,6,8/2/2023 13:24,11,17,0
685,8/23/2023,3,1,62072,5,8/23/2023 13:24,10,15,0
639,9/21/2023,3,1,61111,9,9/21/2023 13:24,10,19,0
683,8/24/2023,3,1,61027,15,8/24/2023 13:34,11,26,0
509,12/13/2023,3,1,60351,10,12/13/2023 13:26,10,20,0
590,10/23/2023,3,1,59213,7,10/23/2023 13:21,10,17,0
388,2/28/2024,3,1,57893,8,2/28/2024 15:03,10,18,0
609,10/11/2023,1,1,57743,5,10/11/2023 3:20,11,16,0
663,9/6/2023,3,1,53108,9,9/6/2023 13:22,10,19,0
438,1/27/2024,1,1,52592,5,1/27/2024 3:19,10,15,0
652,9/13/2023,3,1,49074,7,9/13/2023 13:22,10,17,0
515,12/9/2023,1,1,47305,4,12/9/2023 3:18,10,14,0
552,11/16/2023,1,1,45302,5,11/16/2023 13:39,67,72,0
146,7/31/2024,3,1,44110,8,7/31/2024 13:33,11,19,0
647,9/16/2023,1,1,43435,4,9/16/2023 3:19,10,14,0
575,11/1/2023,3,1,42596,10,11/1/2023 13:26,9,19,0
507,12/14/2023,3,1,41559,10,12/14/2023 13:24,10,20,0
411,2/14/2024,1,1,41226,5,2/14/2024 3:24,10,15,0
705,8/10/2023,3,1,41198,6,8/10/2023 13:30,10,16,0
744,7/17/2023,3,1,41111,7,7/17/2023 13:30,11,18,0
387,2/29/2024,1,1,40782,10,2/29/2024 3:28,12,22,0
766,7/3/2023,3,1,40754,5,7/3/2023 13:24,10,15,0
866,5/1/2023,1,1,34998,3,5/1/2023 8:29,9,12,0
564,11/8/2023,3,1,34561,7,11/8/2023 13:22,10,17,0
849,5/11/2023,1,1,34139,3,5/11/2023 2:21,10,13,0
844,5/15/2023,1,1,34002,4,5/15/2023 2:27,9,13,0
778,6/26/2023,1,1,33626,4,6/26/2023 3:22,9,13,0
420,2/8/2024,1,1,30911,4,2/8/2024 3:24,11,15,0
508,12/14/2023,1,1,28522,14,12/14/2023 3:32,11,25,0
658,9/9/2023,1,1,27398,4,9/9/2023 3:20,10,14,0
416,2/10/2024,1,1,24907,4,2/10/2024 5:08,9,13,0
493,12/23/2023,1,1,23870,8,12/23/2023 3:27,10,18,0
614,10/7/2023,1,1,23205,6,10/7/2023 3:19,10,16,0
585,10/26/2023,1,1,22078,9,10/26/2023 3:24,11,20,0
651,9/14/2023,1,1,20414,6,9/14/2023 3:21,11,17,0
734,7/24/2023,1,1,19554,4,7/24/2023 3:27,10,14,0
730,7/26/2023,1,1,19498,4,7/26/2023 3:27,10,14,0
851,5/10/2023,1,1,19266,3,5/10/2023 2:26,9,12,0
537,11/25/2023,1,1,17548,4,11/25/2023 3:19,10,14,0
724,7/29/2023,1,1,16586,5,,10,15,0
728,7/27/2023,1,1,16069,18,7/27/2023 3:35,11,29,0
735,7/22/2023,1,1,15739,4,7/22/2023 3:22,10,14,0
394,2/24/2024,1,1,14457,4,2/24/2024 3:19,10,14,0
680,8/26/2023,1,1,13599,3,8/26/2023 3:22,9,12,0
816,6/1/2023,1,1,12897,3,6/1/2023 8:04,9,12,0
409,2/15/2024,1,1,11541,4,2/15/2024 3:19,11,15,0
625,9/30/2023,1,1,11163,4,9/30/2023 3:19,10,14,0
608,10/11/2023,3,1,9565,7,10/11/2023 13:22,9,16,0
581,10/28/2023,1,1,9451,6,10/28/2023 5:11,11,17,0
684,8/24/2023,1,1,8771,3,8/24/2023 3:22,11,14,0
607,10/12/2023,1,1,8705,8,10/12/2023 3:23,10,18,0
480,1/1/2024,3,1,4395,5,1/1/2024 17:04,3,8,0
482,12/30/2023,1,1,2834,4,12/30/2023 3:18,9,13,0
491,12/25/2023,3,1,2692,7,12/25/2023 13:26,9,16,0
504,12/16/2023,1,1,2013,13,12/16/2023 3:28,9,22,0
541,11/23/2023,1,1,87,14,11/23/2023 3:32,10,24,0
457,1/16/2024,1,3,0,12,1/16/2024 4:05,104,116,0
